WWWWWWWWWWWWWWWWWWWWWWWWWWWWWWWW
WFFFFFFFFFFFFFFFFFFFFFFFFFFFFFFW
WFFFFFFFFFFFFFFFFFFFFFFFFFFFFFFW
WFFFFFFFFFFFFFFFFFFFFFFFFFFFFFFW
WFFFFFFFFFFFFFFFFFFFFWFFFFFFFFFW
WFFFFFFFFFFFFFFFFFFFFWFFFFFFFFFW
WFFFFFFFFFFFFFFFFFFFFWFFFFFFFFFW
WFFFFFFFFFFFFFFFFFFFFWFFFFFFFFFW
WFFFFFFFFFWWWWWWWWWWWWWWWWWWWWWW
WFFFFFFFFFWFFFFFFFFFFFFFFFFFFFFW
WFFFFFFFFFWFFFFFFFFFFFFFFFFFFFFW
WFFFFFFFFFWFFFFFFFFFFFFFFFFFFFFW
WFFFFFFFFFWFFFFFFFFFFFFFFFFFFFFW
WFFFFFFFFFFFFFFFFFFFFFFFFFFFFFFW
WFFFFFFFFFFFFFFFFFFFFFFFFFFFFFFW
WFFFFFFFFFFFFFFFFFFFFFFFFFFFFFFW
WFFFFFFFFFFFFFFFFFFFFFFFFFFFFFFW
WWWWWWWWWWWWWWWWWWWWWWWWWWWWWWWW





