32,18,1
1AAAAAAAAAAAAAAAAAAAAAAAAAAAAAA2
D------------------------------B
D------------------------------B
D------------------------------B
D------------------------------B
D-----------5CCCCCC6-----------B
D-----------B~~~~~~D-----------B
D-----------B~~~~~~D-----------B
D-----------B~~~~~~D-----------B
D-----------B~~~~~~D-----------B
D-----------B~~~~~~D-----------B
D-----------B~~~~~~D-----------B
D-----------7AAAAAA8-----------B
D------------------------------B
D------------------------------B
D------------------------------B
D------------------------------B
3CCCCCCCCCCCCCCCCCCCCCCCCCCCCCC4
