32,18,2
1AAAAAAAAAAAAAAAAAAAAAAAAAAAAAA2
D------------------------------B
D------------------------------B
D------------------------------B
D--------------56--------------B
D--------------78--------------B
D------------------------------B
D------------------------------B
D------5CCCC6------5CCCC6------B
D------7AAAA8------7AAAA8------B
D------------------------------B
D------------------------------B
D--------------56--------------B
D--------------78--------------B
D------------------------------B
D------------------------------B
D------------------------------B
3CCCCCCCCCCCCCCCCCCCCCCCCCCCCCC4
