32,18,0
1AAAAAAAAAAAAAAAAAAAAAAAAAAAAAA2
D------------------------------B
D------------------------------B
D------------------------------B
D------------------------------B
D------------------------------B
D------------------------------B
D------------------------------B
D------------------------------B
D------------------------------B
D------------------------------B
D------------------------------B
D------------------------------B
D------------------------------B
D------------------------------B
D------------------------------B
D------------------------------B
3CCCCCCCCCCCCCCCCCCCCCCCCCCCCCC4
