32,18,3
1AAAAAAAAAAAAAAAAAAAAAAAAAAAAAA2
D------------------------------B
D------------------------------B
D------------------------------B
D--------------56--------------B
D--------------BD--------------B
D--------------BD--------------B
D--------------BD--------------B
D----------5CCC43CCC6----------B
D----------7AAA21AAA8----------B
D--------------BD--------------B
D--------------BD--------------B
D--------------BD--------------B
D--------------78--------------B
D------------------------------B
D------------------------------B
D------------------------------B
3CCCCCCCCCCCCCCCCCCCCCCCCCCCCCC4
