32,18,4
~1AAAAAAAAAAAAAAAAAAAAAAAAAAAA2~
18----------------------------72
D------------------------------B
D------------------------------B
D------------------------------B
D----5C6----------------5C6----B
D----B~D----------------B~D----B
D----B~D----------------B~D----B
D----B~D----------------B~D----B
D----B~D----------------B~D----B
D----B~D----------------B~D----B
D----B~D----------------B~D----B
D----7A8----------------7A8----B
D------------------------------B
D------------------------------B
D------------------------------B
36----------------------------54
~3CCCCCCCCCCCCCCCCCCCCCCCCCCCC4~
