32,18,4
1AAAAAAAAAAAAAAAAAAAAAAAAAAAAAA2
D------------------------------B
D------------------------------B
D------------------------------B
D------------------------------B
D-----------5C6--5C6-----------B
D-----------B18--72D-----------B
D-----------78----78-----------B
D------------------------------B
D------------------------------B
D-----------56----56-----------B
D-----------B36--54D-----------B
D-----------7A8--7A8-----------B
D------------------------------B
D------------------------------B
D------------------------------B
D------------------------------B
3CCCCCCCCCCCCCCCCCCCCCCCCCCCCCC4
