32,18,1
~~~~~1AAAAAAAAAAAAAAAAAAAA2~~~~~
~~~~~D--------------------B~~~~~
~~~~~D--------------------B~~~~~
~~~~~D--------------------B~~~~~
~~~~~D--------------------B~~~~~
1AAAA8--------------------7AAAA2
D------------------------------B
D------------------------------B
D------------------------------B
D------------------------------B
D------------------------------B
D------------------------------B
3CCCC6--------------------5CCCC4
~~~~~D--------------------B~~~~~
~~~~~D--------------------B~~~~~
~~~~~D--------------------B~~~~~
~~~~~D--------------------B~~~~~
~~~~~3CCCCCCCCCCCCCCCCCCCC4~~~~~
