32,18,3
1AAAAAAAAAAAAAAAAAAAAAAAAAAAAAA2
D------------------------------B
D------------------------------B
D------------------------------B
D---56--------------------56---B
D---78--------------------78---B
D------------------------------B
D------------------------------B
D------------------------------B
D------------------------------B
D------------------------------B
D------------------------------B
D---56--------------------56---B
D---78--------------------78---B
D------------------------------B
D------------------------------B
D------------------------------B
3CCCCCCCCCCCCCCCCCCCCCCCCCCCCCC4
